10 11
##########
####     #
#  ###  H#
#     r H#
#   ####H#
#   b   H#
##  r  lH#
##  ####H#
#l b    H#
####H  PH#
##########

