10 11
##########
#  r    ##
#H##     #
#H    r H#
#H y  ##H#
#H##    H#
#Hg  y gH#
#H#  ###H#
#H      H#
#H     PH#
##########

