9 11
#########
#       #
#    #H #
#   r H #
#  ###H #
#     H #
# y  gH #
# r###H #
# #   H #
#yg  PH #
#########

