8 10
########
####   #
#    #H#
#   rPH#
#  ###H#
# g y H#
##r ##H#
###   H#
#yg    #
########

