15 9
###############
#          P  #
#H###########H#
#    b    r   #
#H##### #####H#
#  g      g   #
#H##### ####H##
#  r   b      #
###############

