12 11
############
#b  b   M  #
#####   D  #
#          #
#   P      #
#H######   #
#H         #
#H      C  #
#H     MD# #
#H    CD-# #
############