9 5
#########
#DDLDDDD#
#DBCD-DP#
#DDDDDDD#
#########