9 7
#########
#    r-P#
#G   ####
#CB   D##
#DCG  D##
#DDr  B##
#########