9 7
#########
#      M#
#     DC#
#     DM#
#     DG#
#  P-G C#
#########