11 13
######VAO##
#vaoPHHHHH#
#HHHHHHHHH#
######   ##
#         #
#      l  #
#      g  #
#     my  #
#######l###
#######y###
#######g###
#######m###
###########