12 10
############
#DDDDDDDDDD#
#DMDDDDDDDD#
#DDDDDDDDDD#
#DDDDDDDDDD#
#DDDD-PDDDD#
#DDDDDDDDDD#
#DDDDDDDDMD#
#DDDDDDDDDD#
############