7 8
#######
#  G  #
#  #  #
#     #
#P-MD #
##DDG #
###DDM#
###DD##