8 10
########
####   #
#    #H#
#   -yH#
#    #H#
#   DPH#
#  DDD##
##  ####
# y y  #
########