9 10
###A#####
##O  r  #
#   ###H#
#  y yPH#
#y ####H#
#r  gaoH#
##r ###H#
##c   gH#
#cg l l #
#########