9 7
#########
#MgDDD-P#
#Cb bDDD#
#MgyDDRD#
#RCLDBDD#
#LyRBRDD#
#########