9 7
#########
#    G-P#
#   CD###
#  MLD###
# GCDD###
#MLDDD###
#########